[[ 1  1  1  1  1  1  1  1  1  1  1  1  1  1  1  1  1  1  1  1  1  1  1  1  1  1]
 [ 1  0  0  0 13 13 13 13  2 13 13 13 13  0  0  0  0  0  0  0  0  0  0  0  0  1]
 [ 1  0  1  0  0  3  0  0 13  0  0  0  0  0  0  0  0  0  0  0  3  0  0  2  0  1]
 [ 1  0  0  0  0  3  0  0 13  0  0  0  0  0  0  0  0  0  0  0  3  0  0  0  0  1]
 [ 1  0  0  0  3  0  0  0 13  0  0  0  0  0  0  0  0  0  0  0  0  3  0  0  0  1]
 [ 1  3  3  3  0  0  0  0 13  0  0  0  0  9  0  0  0  0  0  0  0  0  3  3  3  1]
 [ 1  0  0  0  0  0  0  0  0  0  0  0  0  0  0  0  0  0  0  0  0  0  0  0  0  1]
 [ 1  0  0  0  0  0  0  0  0  0  0  0  0  0  0  0  0  0  0  0  0  0  0  0  0  1]
 [ 1  0  0  0  0  0  9  0  0  0  3  3  0  0  3  3  0  0  0  0  0  0  0  0  0  1]
 [ 1  0  0  0  0  0  3  3  3  3  3  0  0  0  0  3  3  3  3  3  0  0  0  0
   0  1]
 [ 1  0  0  0  0  0  3  0  0  0  0  9  0  0  0  0  0  0  0  3  0  0  0  0
   0  1]
 [ 1  1  0  0  0  0  3  0  0  0  0  0  0  0  0  0  0  0  9  3  0  0  0  0
   1  1]
 [ 1  4  1  0  0  0  0  0  0  0  0  0  0  0  0  0  0  0  0  0  0  0  0  1
   4  1]
 [ 1  1  1  1  1  1  1  1  1  1  1  1  1  1  1  1  1  1  1  1  1  1  1  1
   1  1]]
