[[ 1  1  1  1  1  1  1  1  1  1  1  1  1  1  1  1  1  1  1  1  1  1  1  1 1  1]
 [ 1 13  0  0  0  1  0  0  0  9  0  0  9  0  0  9  0  0  0  0  1  0  0  0 0  1]
 [ 1 13  2  0  0  1  0  0  0  0  0  0  0  0  9  0  0  0  0  0  1  0  0  3 0  1]
 [ 1 13  0  0  0  1  0  0  0  0  0  0  0  0  0  0  0  0  0  0  1  0  0  0 0  1]
 [ 1 13 13 13 13  1  0  0  0  0  0  0  0  0  0  0  0  0  0  9  1  0  0  9 1  1]
 [ 1 13  0  0  0  0  0  0  0  0  0  0  0  0  0  0  0  0  0  0 -1  0  0  0 0  1]
 [ 1 13  0  0  0  0  0  0  0  0  0  0  0  0  0  0  0  0  0  0 -1  0  0  0 13  1]
 [ 1 13  0  0  0  0  0  0  0  0  0  0  0  0  0  0  0  0  0  0 -1  0  0  0 13  1]
 [ 1 13  0  0  0  0  0  0  0  0  0  0  0  0  0  0  0 -1 -1 -1  2 -1 -1 -1 13  1]
 [ 1  1  1  9  0  1  0  0  0  0  0  0  0  0  0  0  0  0  0  0  1  9  0  0 13  1]
 [ 1  0  0  0  0  1  0  0  0  0  0  0  0  0  0  9  9  0  0  0  1 13 13 13 13  1]
 [ 1  0  3  0  0  1  0  9  0  0  0  1  1  1  1  7  7  9  0  0  1  0  0  5 13  1]
 [ 1  0  0  0  0  1  0  0  0  0  0  1  4  4  1  0  0  0  0  0  1  6  9  5 13  1]
 [ 1  1  1  1  1  1  1  1  1  1  1  1  1  1  1  1  1  1  1  1  1  1  1  1 1  1]]
